3 6 703 681 702 701 709 700 
3 6 696 676 697 698 704 699 
3 4 699 760 786 839 
2 6 699 727 747 781 795 825 
1 5 839 835 821 812 825 
1 5 825 840 826 850 841 
3 6 699 648 610 554 526 520 
3 7 520 510 516 511 504 518 508 
2 5 508 555 590 616 629 
2 6 508 1364 527 544 545 565 
1 7 629 666 656 714 761 744 772 
1 4 629 593 594 565 
1 5 617 640 678 732 772 
1 4 772 808 837 842 
1 5 842 868 889 907 899 
3 4 700 763 787 848 
2 6 700 728 748 782 800 830 
1 5 848 836 824 815 830 
1 5 830 847 829 828 846 
3 5 521 560 592 653 700 
3 7 521 529 517 514 505 519 509 
2 5 509 558 591 619 630 
2 6 509 1365 528 549 548 568 
1 4 630 597 596 568 
1 7 630 669 657 715 762 745 773 
1 5 773 734 679 641 618 
1 4 773 809 838 845 
1 5 845 871 890 908 900 
3 5 930 946 965 982 963 
1 6 963 978 994 1005 1014 1034 
3 5 931 950 966 983 964 
1 6 964 979 995 1006 1017 1035 
1 4 610 638 671 649 
1 3 649 612 590 
1 3 591 613 652 
1 5 592 615 643 674 652 
